{
  "farm": {
    "level": [
      [18, 6, 6, 6, 6, 14, 6, 6, 6, 18],
      [6, 14, 14, 14, 14, 14, 14, 14, 14, 6],
      [6, 14, 14, 14, 14, 14, 14, 14, 14, 6],
      [6, 14, 14, 14, 14, 14, 14, 14, 14, 6],
      [6, 14, 14, 14, 14, 14, 14, 0, 14, 6],
      [6, 14, 14, 14, 14, 14, 14, 14, 14, 6],
      [6, 14, 14, 14, 14, 14, 14, 14, 14, 6],
      [6, 14, 14, 14, 14, 14, 14, 14, 14, 6],
      [6, 14, 14, 14, 14, 14, 14, 14, 14, 6],
      [18, 6, 6, 6, 6, 6, 6, 6, 6, 18]
    ],

    "up": "none",
    "right": "none",
    "down": "none",
    "left": "none"
  }
}
